Comment[ArrayExpressAccession]	E-GEOD-72509						
MAGE-TAB Version	1.1						
Public Release Date	2015-09-16						
Investigation Title	SLE lupus RNA-seq						
Comment[Submitted Name]	SLE lupus RNA-seq						
Experiment Description	RNA-seq of systemic lupus erythematosus (SLE) whole blood and healthy controls to determine the gene expression changes in these patients. RNA-seq of PAXgene blood from SLE and healthy donors.						
Term Source Name	ArrayExpress	EFO					
Term Source File	http://www.ebi.ac.uk/arrayexpress/	http://www.ebi.ac.uk/efo/efo.owl					
Person Last Name	hung	Hung	Behrens	Townsend	Chaivoropol	Ortmann	Bhangale
Person First Name	Tiffany	Tiffany	Timothy	Michael	Christina	Ward	Tushar
Person Email	tiffanyh@gmail.com						
Person Affiliation	Genentech						
Person Address	Human Genetics, Genentech, 1 DNA Way, South San Francisco, CA, USA						
Person Roles	submitter						
Protocol Name	P-GSE72509-2	P-GSE72509-1					
Protocol Description	RNA was extracted from PAXgene tubes. RNA libraries were prepared for sequencing using standard Illumina protocols.	None					
Protocol Type	nucleic acid library construction protocol	growth protocol					
Experimental Factor Name	disease						
Experimental Factor Type	disease						
PubMed ID	26382853						
Publication DOI	10.1126/science.aac7442						
Publication Title	The Ro60 autoantigen binds endogenous retroelements and regulates inflammatory gene expression						
Publication Author List	Hung T, Pratt GA, Sundararaman B, Townsend MJ, Chaivorapol C, Bhangale T, Graham RR, Ortmann W, Criswell LA, Yeo GW, Behrens TW						
Comment[AEExperimentDisplayName]	RNA-seq of blood cells from 99 systemic lupus erythematosus patients and 18 healthy controls						
Comment[SecondaryAccession]	GSE72509						
Comment[GEOReleaseDate]	2015-09-16						
Comment[ArrayExpressSubmissionDate]	2015-08-28						
Comment[GEOLastUpdateDate]	2015-09-18						
Comment[AEExperimentType]	RNA-seq of coding RNA						
Comment[AdditionalFile:Data1]	GSE72509_SLE_RPKMs.txt						
Comment[SecondaryAccession]	SRP062966						
SDRF File	E-GEOD-72509.sdrf.txt						
